W,W,W,W,W,W,W
W,,,,,,W
W,,,,Summoning Circle,,W
W,,,,,,W
W,,,,,,W
W,,,,,,W
W,W,W,D1,W,W,W
,,W,,W,,,
,,W,,W,,,
,,W,,W,,,
,,W,,W,,,
W,W,W,D2,W,W,W
W,,,,,,W
W,,,,,,W
W,,,,,,W
W,,,,,,W
W,Summoning Circle,,,,,W
W,,,,,,W
W,,,,,,W
W,,,,,,W
W,W,W,D2,W,W,W
,,W,,W,,,
,,W,,W,,,
,,W,,W,,,
,,W,,W,,,
W,W,W,D3,W,W,W
W,,,,,,W
W,,,,,,W
W,,,,,,W
W,,,,,,W
W,,,,,,W
W,,,,,,W
W,,,Spawn,,,W
W,,,,,,W
W,,,,,,W
W,,,,,,W
W,,,,,,W
W,,,,,,W
W,W,W,W,W,W,W